0,0,0,0,0,0,0,0,0,0,0,0,0,0,0,0,0,0
0,0,0,0,0,0,0,0,0,0,0,0,0,0,0,0,0,0
0,0,0,0,0,0,0,0,0,0,0,0,0,0,0,0,0,0
0,0,0,0,0,0,0,0,0,0,0,0,0,0,0,0,0,0
0,0,0,0,0,0,0,0,0,0,0,0,0,0,0,0,0,0
0,0,0,0,0,0,0,0,0,0,0,0,0,0,0,0,0,0
0,0,0,0,0,0,0,0,0,0,0,0,0,0,0,0,0,0
0,0,0,0,0,0,0,0,0,0,0,0,0,0,0,0,0,0
0,0,0,0,0,0,0,0,0,0,0,0,0,0,0,0,0,0
2,2,2,2,2,2,2,2,2,2,2,2,2,2,2,2,2,2
2,10,10,10,10,10,10,10,2,10,10,10,10,10,10,10,10,2
2,10,10,10,10,10,10,10,2,10,10,10,10,10,10,10,10,2
2,10,10,10,10,10,10,10,2,10,10,10,10,10,10,10,10,2
2,10,10,10,10,10,10,10,2,10,10,10,10,10,10,10,10,2
2,12,13,10,10,999,10,15,34,10,104,10,10,10,10,10,23,2
2,2,2,2,2,2,2,2,2,2,2,2,2,2,2,2,2,2