2,2,2,2,2,2,2,2,2,2,2,2,2,2,2,2,2,2
2,10,10,10,10,10,10,10,10,10,10,10,10,10,10,10,10,2
2,10,10,10,10,10,10,10,10,10,10,10,10,10,10,10,10,2
2,10,10,10,10,10,10,10,10,10,10,10,10,10,26,10,23,2
2,10,10,10,10,10,10,10,10,10,10,10,10,10,27,2,2,2
2,10,10,10,10,10,10,10,10,10,10,10,10,10,27,10,10,2
2,10,10,10,10,10,10,10,10,10,10,10,10,10,27,10,10,2
2,10,10,10,10,10,10,10,10,10,10,10,10,10,27,10,10,2
2,10,10,10,10,10,10,10,10,10,10,10,10,10,27,10,10,2
2,10,10,10,10,10,10,10,10,10,10,10,10,10,27,10,10,2
2,10,10,10,10,10,10,10,10,10,10,10,10,10,27,10,10,2
2,10,10,10,10,10,10,10,10,10,10,10,10,10,27,10,10,2
2,10,10,10,10,10,10,10,10,10,10,10,10,10,27,10,10,2
2,10,10,10,10,10,10,10,10,10,10,10,10,10,27,10,10,2
2,10,10,10,999,10,10,10,10,10,10,10,10,10,28,10,10,2
2,2,2,2,2,2,2,2,2,2,2,2,2,2,2,2,2,2