2,2,2,2,2,2,2,2,2,2,2,2,2,2,2,2,2,2,2,2,2,2,2
2,5,5,5,5,5,5,5,5,5,5,5,5,5,5,5,5,5,5,5,5,5,2
2,5,5,103,5,5,5,5,5,5,5,5,5,5,5,5,5,5,101,5,23,5,2
2,5,2,2,2,2,2,5,5,11,5,11,5,11,5,5,2,2,2,2,2,2,2
2,5,5,5,5,5,2,5,5,5,5,5,5,5,5,5,2,5,5,5,5,5,2
2,5,5,5,5,5,2,5,5,5,5,5,5,5,5,5,2,5,5,5,5,5,2
2,11,5,5,11,5,2,30,5,5,5,5,5,5,5,30,2,5,5,5,5,5,2
2,5,5,5,5,5,2,5,5,5,5,5,5,5,5,5,2,5,5,5,5,5,2
2,5,5,5,5,5,2,5,5,5,30,5,5,5,5,5,2,5,5,5,5,5,2
2,5,5,11,5,5,2,5,5,30,2,30,5,5,5,5,2,5,5,5,5,5,2
2,207,5,5,5,5,2,5,5,5,30,5,5,5,5,5,2,5,5,5,5,5,2
2,11,5,5,5,5,2,5,5,5,5,5,5,5,5,5,2,5,5,5,5,5,2
2,5,5,5,5,5,2,5,5,5,5,5,5,30,5,5,2,5,5,5,5,5,2
2,5,5,5,5,5,2,5,5,5,5,5,30,2,30,5,2,5,5,5,5,5,2
2,5,11,5,5,5,2,5,30,5,5,5,5,30,5,5,2,5,5,5,5,5,2
2,5,5,5,5,5,2,5,2,30,5,5,5,5,5,5,2,5,5,5,5,5,2
2,5,5,5,5,11,2,5,30,5,5,5,5,5,5,5,2,5,5,5,5,5,2
2,5,5,5,5,5,2,5,5,5,5,5,5,5,5,5,2,5,5,5,5,5,2
2,5,5,5,5,5,2,5,5,5,5,30,5,5,5,5,2,5,5,5,5,5,2
2,5,11,5,5,5,5,5,5,5,30,2,30,5,5,5,2,5,5,5,5,5,2
2,5,5,5,5,5,2,5,5,5,5,30,5,5,206,5,2,5,5,5,5,5,2
2,5,5,5,11,5,2,5,5,5,5,5,5,5,5,5,2,5,5,5,5,5,2
2,5,5,5,5,5,2,5,5,5,5,5,5,5,5,5,2,5,5,5,5,5,2
2,5,5,5,5,5,2,5,30,5,5,5,5,5,5,5,2,5,5,5,5,5,2
2,5,5,5,5,5,2,5,2,30,5,5,5,5,30,5,2,5,5,5,5,5,2
2,5,5,5,5,5,2,5,30,5,5,5,5,30,2,5,2,5,5,5,5,5,2
2,5,5,5,5,5,2,5,5,5,5,5,5,5,30,5,2,5,5,5,5,5,2
2,5,5,5,5,5,2,5,5,5,5,5,5,5,5,5,2,5,5,5,5,5,2
2,5,5,5,5,5,2,5,5,5,5,5,5,5,5,5,2,5,5,5,5,5,2
2,5,5,5,5,5,2,5,5,5,5,30,5,5,5,5,2,5,5,5,5,5,2
2,5,5,5,5,5,2,5,5,5,30,2,30,5,5,5,2,5,5,5,5,5,2
2,5,5,5,5,5,2,5,5,5,5,30,5,5,5,5,2,5,5,5,5,5,2
2,5,5,5,5,5,2,5,5,5,5,5,5,5,5,5,2,5,5,5,5,5,2
2,5,5,5,5,5,2,5,5,5,5,5,5,5,5,5,2,5,5,5,5,5,2
2,5,5,5,5,5,2,5,5,5,5,5,5,5,5,5,2,5,5,5,5,5,2
2,2,2,2,2,2,2,5,5,5,5,5,5,30,5,5,2,5,5,5,5,5,2
2,5,5,5,5,5,2,5,5,5,5,5,30,2,30,5,2,5,5,5,5,5,2
2,5,5,5,5,5,2,5,5,5,5,5,5,30,5,5,2,5,5,5,5,5,2
2,5,203,205,203,5,2,5,5,5,5,5,5,5,5,5,2,5,5,5,5,5,2
2,5,203,203,203,5,34,5,24,5,999,5,5,5,5,5,2,5,5,5,5,5,2
2,2,2,2,2,2,2,2,2,2,2,2,2,2,2,2,2,2,2,2,2,2,2
