2,2,2,2,2,2,2,2,2,2,2,2,2,2,2,2,2,2,2,2,2,2,2,2,2,2,2,2,2,2,2
2,10,10,10,10,10,10,10,10,10,10,10,30,30,30,30,30,30,30,30,30,30,30,30,30,30,30,2,10,10,2
2,10,205,10,10,10,10,10,10,10,10,10,10,10,10,10,10,10,10,10,10,10,10,10,10,10,10,34,10,23,2
2,10,11,10,10,10,10,10,10,10,10,10,10,10,10,10,10,10,10,10,10,10,10,10,10,10,3,2,2,2,2
2,10,10,10,10,10,10,10,10,10,10,10,10,10,10,10,10,10,10,10,10,10,10,10,10,10,10,10,10,10,2
2,10,10,10,10,10,10,10,10,10,10,10,10,10,10,10,10,10,10,10,11,11,10,10,10,10,10,10,10,10,2
2,10,10,10,10,10,10,11,11,10,10,11,11,10,10,10,10,10,10,10,10,10,10,10,10,10,10,10,10,10,2
2,10,10,10,10,11,11,10,10,10,5,5,5,10,10,10,10,10,10,10,10,10,10,10,10,10,10,10,10,10,2
2,10,10,10,10,10,10,10,10,10,5,5,5,10,10,10,10,11,11,10,10,10,10,10,10,24,10,10,10,10,2
2,10,11,11,10,10,10,10,10,10,5,5,5,10,10,11,11,10,10,10,10,10,10,10,11,11,10,10,10,10,2
2,10,10,10,10,10,10,10,10,10,10,10,10,10,10,10,10,10,10,10,10,10,10,10,10,10,10,10,10,10,2
2,10,10,10,10,10,10,10,10,10,10,10,11,11,10,10,10,10,10,10,10,10,10,10,10,10,10,10,10,10,2
2,10,10,10,10,10,10,10,10,11,11,10,10,10,10,10,10,10,10,11,11,10,10,10,10,10,10,2,34,2,2
2,16,10,10,10,999,10,10,10,10,10,10,10,10,10,10,10,10,10,10,10,10,10,10,10,10,10,2,10,10,2
2,2,2,4,2,2,2,10,10,10,10,10,10,10,10,10,10,10,10,10,10,10,10,10,10,10,10,2,10,10,2
2,10,10,10,10,10,10,30,30,30,30,30,10,10,10,206,10,10,10,10,10,10,10,10,10,10,10,2,102,207,2
2,2,2,2,2,2,2,2,2,2,2,2,10,10,10,10,10,10,10,2,2,2,2,2,2,2,2,2,2,2,2